CA,7CHARGE,35,35,0,11,1
CA,ABM,83,5,78,16,1
MA,ABM,29,0,29,4,1
SC,ABM,41,2,39,6,1
MA,AMPUP,1014,3,1011,200,1
GA,AMPUP,39,0,39,13,1
VT,AMPUP,65,6,59,24,1
NC,AMPUP,131,0,131,20,1
IL,AMPUP,77,0,77,32,1
DC,AMPUP,103,0,103,19,1
OH,AMPUP,131,0,131,55,1
LA,AMPUP,43,0,43,15,1
RI,AMPUP,66,0,66,12,1
NY,AMPUP,408,0,408,91,1
CA,AMPUP,1143,4,1139,212,1
MI,AMPUP,52,0,52,16,1
FL,AMPUP,139,0,139,55,1
CT,AMPUP,766,1,765,186,1
MO,AMPUP,103,0,103,33,1
NJ,AMPUP,127,0,127,50,1
TX,AMPUP,185,0,185,53,1
CO,AMPUP,94,0,94,29,1
AL,AMPUP,11,0,11,4,1
AZ,AMPUP,117,0,117,30,1
CT,APPLEGREEN,44,44,0,16,1
CA,AUTEL,104,11,93,12,1
IL,BP_PULSE,68,68,0,15,1
CA,BP_PULSE,106,106,0,9,0.88888888888888884
MA,Blink Network,323,16,307,80,0.975
AR,Blink Network,174,18,156,63,0.88888888888888884
KS,Blink Network,63,10,53,27,0.96296296296296291
TX,Blink Network,1228,92,1136,409,0.921760391198044
CO,Blink Network,783,27,756,196,0.93877551020408168
MI,Blink Network,251,61,190,80,0.9
IA,Blink Network,165,53,112,56,0.9642857142857143
MD,Blink Network,1096,60,1036,322,0.9503105590062112
MN,Blink Network,319,74,245,95,0.93684210526315792
NC,Blink Network,549,39,510,166,0.9337349397590361
OK,Blink Network,82,20,62,23,0.86956521739130432
NE,Blink Network,51,14,37,15,0.93333333333333335
WV,Blink Network,75,6,69,24,0.91666666666666663
PA,Blink Network,558,89,469,183,0.907103825136612
OR,Blink Network,695,53,642,213,0.92488262910798125
NM,Blink Network,53,16,37,18,1
ME,Blink Network,99,6,93,17,0.88235294117647056
NV,Blink Network,122,0,122,23,0.91304347826086951
IL,Blink Network,547,108,439,156,0.92948717948717952
WA,Blink Network,1256,36,1220,317,0.93690851735015768
AZ,Blink Network,657,19,638,192,0.921875
NJ,Blink Network,554,60,494,150,0.93333333333333335
AL,Blink Network,149,16,133,47,1
GA,Blink Network,734,19,715,202,0.91089108910891092
WI,Blink Network,263,73,190,83,0.97590361445783136
VT,Blink Network,132,38,94,52,0.96153846153846156
SC,Blink Network,195,6,189,56,0.9107142857142857
CT,Blink Network,279,22,257,62,0.87096774193548387
KY,Blink Network,103,29,74,30,0.8666666666666667
VA,Blink Network,841,40,801,230,0.92173913043478262
OH,Blink Network,753,115,638,224,0.9241071428571429
DE,Blink Network,205,42,163,61,0.93442622950819676
IN,Blink Network,187,49,138,53,0.96226415094339623
NY,Blink Network,750,56,694,183,0.86338797814207646
TN,Blink Network,508,22,486,177,0.90960451977401124
LA,Blink Network,63,16,47,20,0.9
FL,Blink Network,2554,127,2427,654,0.95107033639143734
ID,Blink Network,156,16,140,52,0.96153846153846156
UT,Blink Network,344,23,321,68,0.94117647058823528
HI,Blink Network,58,0,58,26,0.92307692307692313
MO,Blink Network,169,32,137,62,0.93548387096774188
CA,Blink Network,2570,84,2486,584,0.93664383561643838
DC,Blink Network,479,0,479,125,0.928
CA,CHARGELAB,117,16,101,23,0.91304347826086951
NY,CHARGELAB,112,8,104,33,0.96969696969696972
UT,CHARGELAB,93,0,93,8,0.75
IA,CHARGELAB,146,146,0,41,0.90243902439024393
MA,CHARGELAB,25,0,25,10,1
NY,CHARGESMART_EV,1610,166,1444,214,0.97663551401869164
NJ,CHARGESMART_EV,77,48,29,12,0.91666666666666663
FL,CHARGESMART_EV,83,28,55,11,0.90909090909090906
FL,CHARGEUP,923,31,892,274,0.96350364963503654
NC,CHARGEUP,92,0,92,24,0.625
CA,CHARGIE,285,0,285,10,1
CA,CIRCLE_K,44,44,0,11,1
DE,ChargePoint Network,203,15,188,109,1
DC,ChargePoint Network,203,0,203,106,0.98113207547169812
VT,ChargePoint Network,430,21,409,243,0.99588477366255146
MO,ChargePoint Network,1868,78,1790,992,0.98689516129032262
GA,ChargePoint Network,2266,235,2031,1326,0.98416289592760176
AL,ChargePoint Network,453,130,323,281,0.98220640569395012
KS,ChargePoint Network,816,25,791,425,0.98588235294117643
PA,ChargePoint Network,2036,115,1921,1094,0.99085923217550276
MI,ChargePoint Network,1563,162,1401,887,0.98985343855693353
IA,ChargePoint Network,404,35,369,221,0.99095022624434392
CT,ChargePoint Network,975,77,898,548,0.98540145985401462
NM,ChargePoint Network,396,59,337,258,0.98837209302325579
OR,ChargePoint Network,1135,119,1016,683,0.986822840409956
RI,ChargePoint Network,553,27,526,286,0.986013986013986
AZ,ChargePoint Network,1536,29,1507,851,0.98472385428907172
KY,ChargePoint Network,207,26,181,121,0.97520661157024791
TN,ChargePoint Network,938,110,828,592,0.98986486486486491
MS,ChargePoint Network,95,34,61,66,0.98484848484848486
AR,ChargePoint Network,274,17,257,149,1
ID,ChargePoint Network,93,23,70,62,0.9838709677419355
UT,ChargePoint Network,1190,75,1115,638,0.9890282131661442
NJ,ChargePoint Network,1596,120,1476,914,0.98358862144420134
SD,ChargePoint Network,66,15,51,43,1
NV,ChargePoint Network,702,17,685,358,0.99162011173184361
NY,ChargePoint Network,4329,167,4162,2379,0.98444724674232875
NC,ChargePoint Network,1809,82,1727,989,0.98685540950455009
OH,ChargePoint Network,1789,166,1623,988,0.9919028340080972
NE,ChargePoint Network,429,48,381,239,0.97489539748953979
WA,ChargePoint Network,2884,138,2746,1574,0.98729351969504442
HI,ChargePoint Network,310,4,306,167,0.94610778443113774
OK,ChargePoint Network,179,37,142,112,0.9821428571428571
CO,ChargePoint Network,3286,238,3048,1795,0.98384401114206133
MN,ChargePoint Network,896,37,859,486,0.97942386831275718
VA,ChargePoint Network,1667,68,1599,905,0.99005524861878458
NH,ChargePoint Network,199,24,175,117,0.99145299145299148
MD,ChargePoint Network,1142,73,1069,644,0.99223602484472051
MA,ChargePoint Network,5944,273,5671,3130,0.99009584664536743
LA,ChargePoint Network,179,36,143,104,0.99038461538461542
ME,ChargePoint Network,438,65,373,266,0.98872180451127822
WI,ChargePoint Network,715,49,666,404,0.97277227722772275
MT,ChargePoint Network,73,14,59,43,0.97674418604651159
IL,ChargePoint Network,1433,73,1360,795,0.98616352201257862
SC,ChargePoint Network,343,31,312,181,0.97790055248618779
FL,ChargePoint Network,3226,147,3079,1762,0.98467650397275819
TX,ChargePoint Network,3409,157,3252,1877,0.97496004262120406
IN,ChargePoint Network,569,41,528,329,0.9878419452887538
CA,ChargePoint Network,24515,730,23785,13012,0.9808638180141408
CA,EPIC_CHARGING,83,0,83,9,1
WA,EV Connect,184,71,113,69,0.95652173913043481
IA,EV Connect,66,39,27,21,1
MN,EV Connect,45,27,18,26,0.92307692307692313
AZ,EV Connect,52,14,38,19,0.94736842105263153
OH,EV Connect,118,61,57,49,0.91836734693877553
CO,EV Connect,140,70,70,37,0.83783783783783783
PA,EV Connect,121,35,86,53,0.96226415094339623
VA,EV Connect,92,27,65,26,0.88461538461538458
NE,EV Connect,27,16,11,7,1
CA,EV Connect,1638,173,1465,235,0.902127659574468
TX,EV Connect,138,63,75,62,0.82258064516129037
GA,EV Connect,61,36,25,24,0.95833333333333337
MA,EV Connect,115,43,72,25,0.88
MI,EV Connect,145,76,69,51,0.90196078431372551
NJ,EV Connect,190,19,171,49,0.91836734693877553
IL,EV Connect,90,50,40,38,0.94736842105263153
FL,EV Connect,259,126,133,85,0.95294117647058818
NY,EV Connect,1146,102,1044,260,0.823076923076923
IN,EV Connect,134,97,37,49,0.87755102040816324
KY,EV Connect,25,13,12,14,0.7857142857142857
NC,EV Connect,419,119,300,141,0.93617021276595747
CA,EVCS,1122,545,577,188,0.97872340425531912
WA,EVCS,108,82,26,25,1
OR,EVCS,125,78,47,46,1
GA,EVGATEWAY,69,10,59,16,0.75
NY,EVGATEWAY,173,44,129,40,0.95
NJ,EVGATEWAY,69,5,64,13,0.92307692307692313
CA,EVGATEWAY,1276,283,993,130,0.90769230769230769
AL,EVGATEWAY,71,31,40,8,0.375
NC,EVGATEWAY,43,6,37,11,0.72727272727272729
CO,EVGATEWAY,170,46,124,43,0.95348837209302328
FL,EVGATEWAY,71,1,70,17,0.88235294117647056
CT,EVGATEWAY,135,4,131,50,0.96
NY,EVIUM,61,0,61,4,1
CA,EVIUM,92,0,92,2,1
CA,EVMATCH,125,0,125,24,1
NY,EVOKE,2033,4,2029,197,1
NJ,EVOKE,230,3,227,37,1
AZ,EVOKE,67,0,67,8,1
CA,EVRANGE,286,86,200,37,0.78378378378378377
NV,EVRANGE,11,8,3,2,0.5
NY,Electrify America,332,327,5,75,1
AZ,Electrify America,123,123,0,28,1
GA,Electrify America,137,137,0,30,1
NJ,Electrify America,150,144,6,30,1
MO,Electrify America,44,44,0,9,1
OH,Electrify America,84,84,0,16,1
FL,Electrify America,263,260,3,53,1
MD,Electrify America,104,103,1,21,1
OR,Electrify America,147,142,5,33,1
MI,Electrify America,74,74,0,14,1
CO,Electrify America,216,213,3,46,1
IL,Electrify America,151,146,5,33,1
NC,Electrify America,111,110,1,20,1
NV,Electrify America,94,94,0,21,1
MA,Electrify America,77,73,4,18,1
VA,Electrify America,231,178,53,37,1
TX,Electrify America,202,198,4,41,1
PA,Electrify America,114,114,0,26,1
UT,Electrify America,92,92,0,19,1
CA,Electrify America,1494,1380,114,315,0.99682539682539684
IN,Electrify America,62,62,0,11,1
WA,Electrify America,248,234,14,56,1
TN,Electrify America,90,90,0,16,1
MN,Electrify America,58,58,0,10,1
OK,FCN,933,724,209,136,0.99264705882352944
MO,FCN,76,52,24,13,1
NM,FCN,76,76,0,19,1
FL,FLASH,63,0,63,9,1
CA,FLASH,204,0,204,18,1
NJ,FLASH,29,0,29,3,1
CO,FLASH,112,0,112,6,1
OH,FLASH,33,0,33,2,1
NV,FLASH,63,0,63,3,1
TX,FLASH,105,0,105,11,1
NY,FLASH,66,0,66,7,1
PA,FLASH,95,0,95,22,1
AZ,FLASH,29,0,29,2,1
GA,FLASH,141,0,141,11,1
CT,FLASH,45,0,45,10,1
NJ,FLO,126,7,119,39,1
PA,FLO,81,4,77,18,0.94444444444444442
CT,FLO,244,8,236,73,1
NY,FLO,391,2,389,82,1
CA,FLO,565,1,564,478,0.9895397489539749
MA,FLO,300,14,286,75,1
MI,FLO,58,2,56,18,1
WI,FLO,37,5,32,20,1
OR,FLO,87,3,84,33,1
WA,FLO,254,38,216,106,0.99056603773584906
OH,FLO,306,13,293,92,1
NY,FORD_CHARGE,70,70,0,20,0.85
FL,FPLEV,333,333,0,90,1
TX,GRAVITI_ENERGY,262,97,165,66,0.90909090909090906
TX,HYPERFUEL,126,126,0,18,0.55555555555555558
CA,LOOP,5264,76,5188,484,1
OH,LOOP,79,8,71,12,1
NY,LOOP,84,0,84,14,1
PA,LOOP,11,0,11,3,1
GA,LOOP,133,0,133,23,1
TX,LOOP,177,10,167,39,1
FL,LOOP,220,2,218,35,1
AL,LOOP,27,0,27,11,1
NM,LOOP,44,24,20,7,1
CO,LOOP,112,4,108,19,1
MA,LOOP,136,0,136,19,1
NC,LOOP,134,0,134,32,1
CT,LOOP,315,8,307,99,1
NJ,LOOP,47,4,43,8,1
TX,MERCEDES_BENZ,151,151,0,87,1
FL,MERCEDES_BENZ,49,49,0,26,1
SC,MERCEDES_BENZ,29,29,0,16,1
GA,NOODOE,55,4,51,16,1
TX,NOODOE,82,2,80,27,0.96296296296296291
KY,NOODOE,25,2,23,10,1
IL,NOODOE,109,38,71,20,1
CA,NOODOE,615,25,590,82,0.90243902439024393
GA,Non-Networked,399,34,365,182,0.97252747252747251
WA,Non-Networked,816,34,782,312,0.98397435897435892
PA,Non-Networked,578,29,549,284,0.98943661971830987
MO,Non-Networked,170,9,161,98,0.98979591836734693
OH,Non-Networked,610,41,569,306,0.96078431372549022
CT,Non-Networked,1104,18,1086,390,0.97692307692307689
NY,Non-Networked,953,35,918,390,0.982051282051282
HI,Non-Networked,205,12,193,98,0.87755102040816324
ID,Non-Networked,111,16,95,49,0.97959183673469385
NM,Non-Networked,103,9,94,49,1
KS,Non-Networked,116,1,115,68,0.98529411764705888
AL,Non-Networked,249,16,233,124,1
MS,Non-Networked,115,4,111,70,0.95714285714285718
CO,Non-Networked,746,32,714,263,0.95437262357414454
ME,Non-Networked,327,19,308,165,0.98181818181818181
MA,Non-Networked,839,36,803,252,0.95634920634920639
RI,Non-Networked,120,7,113,38,1
LA,Non-Networked,119,17,102,76,0.96052631578947367
WI,Non-Networked,126,5,121,81,1
NC,Non-Networked,698,31,667,271,0.977859778597786
VT,Non-Networked,191,14,177,79,0.97468354430379744
AR,Non-Networked,200,4,196,88,0.96590909090909094
NJ,Non-Networked,466,22,444,154,0.961038961038961
MN,Non-Networked,252,26,226,120,0.98333333333333328
AZ,Non-Networked,514,30,484,181,0.97237569060773477
NV,Non-Networked,219,6,213,57,0.92982456140350878
FL,Non-Networked,874,84,790,392,0.951530612244898
OR,Non-Networked,449,14,435,194,0.98969072164948457
WY,Non-Networked,62,4,58,36,0.94444444444444442
NH,Non-Networked,148,5,143,85,0.9882352941176471
IL,Non-Networked,468,49,419,210,0.96666666666666667
MI,Non-Networked,900,46,854,373,0.97587131367292224
WV,Non-Networked,147,20,127,71,1
DC,Non-Networked,116,2,114,42,1
TN,Non-Networked,433,21,412,175,0.99428571428571433
OK,Non-Networked,183,4,179,84,0.98809523809523814
DE,Non-Networked,68,2,66,43,0.97674418604651159
IN,Non-Networked,260,19,241,113,0.96460176991150437
ND,Non-Networked,55,7,48,38,0.97368421052631582
TX,Non-Networked,725,114,611,329,0.96656534954407292
MD,Non-Networked,841,86,755,281,0.99288256227758009
UT,Non-Networked,262,9,253,95,0.968421052631579
SC,Non-Networked,358,17,341,189,0.97883597883597884
AK,Non-Networked,69,13,56,42,1
CA,Non-Networked,6772,704,6068,1469,0.95779441797140907
KY,Non-Networked,180,11,169,98,0.97959183673469385
VA,Non-Networked,767,74,693,306,0.98692810457516345
CA,OpConnect,293,0,293,42,0.7857142857142857
HI,OpConnect,298,84,214,73,0.83561643835616439
OR,OpConnect,366,22,344,162,0.80246913580246915
ME,OpConnect,29,0,29,14,1
WA,OpConnect,215,30,185,29,0.82758620689655171
NJ,OpConnect,135,0,135,22,0.72727272727272729
CO,POWERFLEX,61,2,59,1,1
CA,POWERFLEX,3973,88,3885,232,1
IL,POWERPORT_EVC,79,12,67,13,0.76923076923076927
MN,RED_E,35,20,15,10,1
VT,RED_E,45,14,31,9,1
MI,RED_E,1406,351,1055,354,0.95480225988700562
CT,RED_E,37,5,32,11,1
NY,RED_E,97,34,63,17,1
MA,RED_E,357,236,121,74,0.972972972972973
TX,REVITALIZE,88,0,88,28,1
GA,RIVIAN_ADVENTURE,27,27,0,4,1
WA,RIVIAN_ADVENTURE,27,27,0,4,1
CA,RIVIAN_ADVENTURE,153,153,0,23,1
TN,RIVIAN_WAYPOINTS,91,0,91,45,1
CA,RIVIAN_WAYPOINTS,120,0,120,25,1
GA,SHELL_RECHARGE,260,17,243,115,0.95652173913043481
CT,SHELL_RECHARGE,70,2,68,29,1
HI,SHELL_RECHARGE,47,3,44,24,0.91666666666666663
NY,SHELL_RECHARGE,88,0,88,32,0.96875
OR,SHELL_RECHARGE,58,5,53,29,1
MA,SHELL_RECHARGE,145,7,138,57,0.96491228070175439
DE,SHELL_RECHARGE,37,7,30,13,1
OH,SHELL_RECHARGE,62,19,43,25,1
PA,SHELL_RECHARGE,204,7,197,98,0.87755102040816324
AZ,SHELL_RECHARGE,61,8,53,27,0.92592592592592593
TX,SHELL_RECHARGE,640,206,434,202,0.96534653465346532
SC,SHELL_RECHARGE,52,16,36,17,1
CA,SHELL_RECHARGE,1282,122,1160,348,0.94252873563218387
MD,SHELL_RECHARGE,177,1,176,80,0.9875
CO,SHELL_RECHARGE,62,24,38,18,0.94444444444444442
WA,SHELL_RECHARGE,197,8,189,92,0.91304347826086951
VA,SHELL_RECHARGE,181,4,177,83,0.97590361445783136
MO,SHELL_RECHARGE,35,0,35,9,0.66666666666666663
NJ,SHELL_RECHARGE,164,12,152,61,0.93442622950819676
IL,SHELL_RECHARGE,243,8,235,118,0.97457627118644063
MI,SHELL_RECHARGE,71,19,52,27,1
CA,STAY_N_CHARGE,11,0,11,6,1
OH,SWTCH,85,0,85,26,1
CA,SWTCH,177,2,175,32,0.90625
ME,SWTCH,33,0,33,8,1
GA,SWTCH,51,2,49,21,0.8571428571428571
NY,SWTCH,459,23,436,106,0.98113207547169812
MA,SWTCH,133,7,126,21,0.8571428571428571
MD,SWTCH,1226,229,997,289,1
PA,SWTCH,45,3,42,12,0.75
NC,SWTCH,55,0,55,13,0.92307692307692313
CA,TURNONGREEN,83,0,83,25,0.76
VA,Tesla,835,831,4,93,1
TN,Tesla,533,529,4,39,1
OH,Tesla,555,555,0,55,1
OR,Tesla,558,558,0,53,1
VT,Tesla,78,78,0,8,1
ID,Tesla,122,122,0,14,1
FL,Tesla,2248,2248,0,203,1
LA,Tesla,199,199,0,19,1
NV,Tesla,826,826,0,60,1
CT,Tesla,442,440,2,41,1
DE,Tesla,188,188,0,20,1
MD,Tesla,582,582,0,63,1
NM,Tesla,162,162,0,18,1
GA,Tesla,989,989,0,75,1
WA,Tesla,890,890,0,79,1
AZ,Tesla,858,858,0,56,1
PA,Tesla,977,977,0,102,1
MT,Tesla,152,152,0,20,1
SC,Tesla,403,403,0,35,1
WI,Tesla,319,319,0,36,1
OK,Tesla,150,150,0,12,1
NH,Tesla,186,186,0,19,1
MI,Tesla,386,386,0,40,1
CA,Tesla,9667,9661,6,589,1
NY,Tesla,1177,1177,0,115,1
UT,Tesla,344,344,0,33,1
MN,Tesla,288,288,0,33,1
IA,Tesla,158,158,0,19,1
WV,Tesla,130,130,0,17,1
MA,Tesla,654,654,0,63,1
NC,Tesla,1010,1010,0,85,1
IL,Tesla,847,847,0,71,1
KS,Tesla,162,162,0,18,1
NJ,Tesla,1104,1104,0,95,1
SD,Tesla,68,68,0,10,1
AL,Tesla,466,466,0,36,1
ME,Tesla,200,200,0,23,1
IN,Tesla,496,496,0,46,1
MO,Tesla,329,329,0,33,1
TX,Tesla,2385,2385,0,198,1
MS,Tesla,136,136,0,13,1
CO,Tesla,560,560,0,55,1
NE,Tesla,92,92,0,11,1
AR,Tesla,93,87,6,11,1
KY,Tesla,186,186,0,18,1
FL,Tesla Destination,1785,0,1785,459,1
DC,Tesla Destination,164,0,164,44,1
OH,Tesla Destination,350,0,350,117,1
CT,Tesla Destination,184,0,184,55,1
KS,Tesla Destination,58,0,58,23,1
AZ,Tesla Destination,451,0,451,121,1
CA,Tesla Destination,4208,0,4208,953,1
IL,Tesla Destination,526,0,526,125,1
MD,Tesla Destination,190,0,190,62,1
WV,Tesla Destination,84,0,84,30,1
VT,Tesla Destination,251,0,251,50,1
MT,Tesla Destination,62,0,62,24,1
MI,Tesla Destination,181,0,181,70,1
AR,Tesla Destination,200,0,200,44,1
KY,Tesla Destination,170,0,170,43,1
NM,Tesla Destination,86,0,86,28,1
ID,Tesla Destination,73,0,73,25,1
MN,Tesla Destination,298,0,298,76,1
WA,Tesla Destination,458,0,458,134,1
OR,Tesla Destination,323,0,323,121,1
OK,Tesla Destination,113,0,113,32,1
AL,Tesla Destination,213,0,213,52,1
NJ,Tesla Destination,366,0,366,75,1
NY,Tesla Destination,1625,0,1625,504,1
NV,Tesla Destination,508,0,508,83,1
VA,Tesla Destination,552,0,552,176,1
GA,Tesla Destination,829,0,829,196,1
TX,Tesla Destination,1345,0,1345,412,1
TN,Tesla Destination,273,0,273,81,1
ME,Tesla Destination,169,0,169,71,1
WI,Tesla Destination,197,0,197,74,1
UT,Tesla Destination,273,0,273,77,1
SD,Tesla Destination,65,0,65,23,1
NC,Tesla Destination,417,0,417,132,1
MA,Tesla Destination,161,0,161,65,1
SC,Tesla Destination,288,0,288,87,1
MO,Tesla Destination,245,0,245,71,1
PA,Tesla Destination,364,0,364,126,1
CO,Tesla Destination,438,0,438,114,1
NH,Tesla Destination,76,0,76,33,1
LA,Tesla Destination,140,0,140,40,1
MS,Tesla Destination,146,0,146,38,1
IN,Tesla Destination,190,0,190,54,1
TX,UNIVERSAL,505,4,501,204,1
WA,Unknown,0,0,0,1,0
FL,Unknown,0,0,0,1,0
TX,Unknown,0,0,0,14,0
CO,Unknown,0,0,0,1,0
VT,VIALYNK,93,44,49,26,0.88461538461538458
CT,VIALYNK,33,14,19,7,0.8571428571428571
NY,VIALYNK,3217,107,3110,592,0.88851351351351349
MA,VIALYNK,68,24,44,12,1
CA,VIALYNK,140,17,123,27,0.25925925925925924
NJ,VIALYNK,89,29,60,22,0.81818181818181823
FL,VIALYNK,27,0,27,5,0.8
CA,WATT_EV,440,440,0,12,0.41666666666666669
WI,ZEFNET,55,22,33,24,1
MN,ZEFNET,484,121,363,181,0.994475138121547
NC,eVgo Network,70,69,1,21,0.90476190476190477
GA,eVgo Network,134,114,20,34,0.97058823529411764
MD,eVgo Network,99,91,8,27,1
WA,eVgo Network,113,109,4,28,0.9285714285714286
OH,eVgo Network,137,137,0,34,0.97058823529411764
NJ,eVgo Network,111,106,5,25,1
NY,eVgo Network,107,105,2,30,0.93333333333333335
TX,eVgo Network,334,309,25,89,0.97752808988764039
MA,eVgo Network,82,74,8,21,1
AZ,eVgo Network,73,73,0,20,0.95
SC,eVgo Network,33,33,0,13,1
CA,eVgo Network,1834,1759,75,425,0.95294117647058818
IL,eVgo Network,149,141,8,38,1
CO,eVgo Network,110,100,10,27,0.92592592592592593
PA,eVgo Network,113,112,1,29,0.96551724137931039
FL,eVgo Network,161,154,7,43,0.83720930232558144
VA,eVgo Network,219,213,6,66,0.93939393939393945
TN,eVgo Network,33,32,1,8,1
WY,AMPUP,1,0,1,1,1
OK,AUTEL,1,0,1,1,1
OH,AUTEL,1,0,1,1,1
KS,CHARGELAB,1,0,1,1,1
MI,CHARGELAB,1,0,1,1,1
OK,CHARGELAB,1,0,1,1,1
OH,CHARGEUP,1,0,1,1,1
MI,CHARGIE,1,1,0,1,1
PR,ChargePoint Network,1,0,1,1,1
CT,EPIC_CHARGING,1,0,1,1,1
ID,EPIC_CHARGING,1,0,1,1,1
VT,EPIC_CHARGING,1,0,1,1,1
TN,EVBOLT,1,0,1,1,1
HI,EVGATEWAY,1,0,1,1,1
MO,EVRANGE,1,1,0,1,1
IA,EVRANGE,1,0,1,1,1
NE,FLO,1,1,0,1,1
WV,FLO,1,1,0,1,1
MS,FLO,1,1,0,1,1
OH,IN_CHARGE,1,1,0,1,1
TX,IN_CHARGE,1,1,0,1,1
ME,LOOP,1,0,1,1,1
PR,NOODOE,1,0,1,1,1
MD,RED_E,1,1,0,1,0
SC,SWTCH,1,0,1,1,1
CO,SWTCH,1,0,1,1,1
VT,TURNONGREEN,1,0,1,1,0
TX,TURNONGREEN,1,0,1,1,1
CO,TURNONGREEN,1,0,1,1,1
MD,TURNONGREEN,1,0,1,1,1
MI,TURNONGREEN,1,0,1,1,1
MA,TURNONGREEN,1,0,1,1,1
NJ,UNIVERSAL,1,0,1,1,1
IL,VIALYNK,1,1,0,1,1
TN,VIALYNK,1,0,1,1,0
FL,WAVE,1,1,0,1,1
PA,ZEFNET,1,0,1,1,1
MD,7CHARGE,2,2,0,1,1
IL,7CHARGE,2,2,0,1,1
NJ,7CHARGE,2,0,2,1,1
MO,ABM,2,0,2,1,1
DE,AMPUP,2,0,2,1,1
OK,AMPUP,2,0,2,1,1
FL,AUTEL,2,2,0,1,1
NJ,AUTEL,2,0,2,2,1
WV,AUTEL,2,2,0,1,1
DC,AUTEL,2,0,2,1,1
SC,AUTEL,2,0,2,1,1
NY,BP_PULSE,2,2,0,1,1
NC,CHAEVI,2,2,0,1,1
FL,CHAEVI,2,2,0,1,1
NY,CHAEVI,2,2,0,1,1
MI,CHAEVI,2,2,0,1,1
NV,CHARGELAB,2,0,2,2,1
ME,CHARGELAB,2,0,2,1,1
IL,CHARGELAB,2,2,0,1,1
RI,CHARGELAB,2,2,0,1,0
MN,CHARGELAB,2,0,2,1,0
SD,CHARGELAB,2,2,0,1,1
CA,CHARGEUP,2,0,2,1,1
NM,CHARGEUP,2,0,2,1,0
NJ,CHARGEUP,2,2,0,1,1
NH,CIRCLE_K,2,2,0,1,1
MA,ELECTRIC_ERA,2,2,0,1,1
IL,EPIC_CHARGING,2,0,2,1,1
TX,EPIC_CHARGING,2,0,2,1,1
NC,EPIC_CHARGING,2,0,2,1,1
NJ,EPIC_CHARGING,2,0,2,2,1
WI,EPIC_CHARGING,2,0,2,1,1
GA,EPIC_CHARGING,2,0,2,1,1
NH,EPIC_CHARGING,2,2,0,1,1
TN,EVGATEWAY,2,0,2,1,1
SD,EVGATEWAY,2,0,2,1,1
NH,EVGATEWAY,2,0,2,1,1
VT,EVGATEWAY,2,2,0,1,1
MN,EVGATEWAY,2,2,0,1,1
KY,EVGATEWAY,2,0,2,1,1
KY,EVMATCH,2,0,2,1,1
WA,EVMATCH,2,0,2,2,1
LA,EVMATCH,2,0,2,1,1
WI,EVOKE,2,0,2,1,1
TX,EVOKE,2,0,2,1,1
CA,EVOKE,2,0,2,1,1
DE,EVOKE,2,0,2,1,1
CO,EVRANGE,2,0,2,1,1
TN,EVRANGE,2,0,2,1,1
MD,EVRANGE,2,0,2,1,1
MN,EVRANGE,2,2,0,1,0
OR,FLASH,2,0,2,1,1
MO,FLASH,2,0,2,1,1
MT,FLO,2,0,2,1,1
MO,FLO,2,0,2,1,1
AZ,FLO,2,0,2,1,1
VA,FLO,2,0,2,1,1
TN,FLO,2,0,2,1,1
SC,FORD_CHARGE,2,2,0,1,1
WA,HONEY_BADGER,2,0,2,1,1
MD,IN_CHARGE,2,2,0,1,1
CA,IN_CHARGE,2,2,0,1,1
MT,IN_CHARGE,2,2,0,1,1
NJ,JULE,2,2,0,1,1
VT,LOOP,2,0,2,1,1
MN,LOOP,2,2,0,1,1
NY,MATCHA,2,0,2,1,1
RI,NOODOE,2,0,2,1,1
NH,NOODOE,2,0,2,1,1
PR,Non-Networked,2,0,2,1,0
IA,OpConnect,2,0,2,1,1
MO,OpConnect,2,0,2,1,1
NM,OpConnect,2,0,2,2,1
KS,OpConnect,2,0,2,1,1
MO,POWERPORT_EVC,2,0,2,1,1
OR,POWERPUMP,2,0,2,1,1
IL,POWERPUMP,2,2,0,1,1
GA,POWERPUMP,2,2,0,1,1
KS,RED_E,2,0,2,1,1
OK,RED_E,2,2,0,1,0
TN,RED_E,2,2,0,1,1
ND,RED_E,2,2,0,1,1
OR,RED_E,2,2,0,1,1
OK,REVITALIZE,2,0,2,1,1
NY,RIVIAN_WAYPOINTS,2,0,2,1,1
WY,RIVIAN_WAYPOINTS,2,0,2,1,1
AL,RIVIAN_WAYPOINTS,2,0,2,1,1
FL,RIVIAN_WAYPOINTS,2,0,2,1,1
MS,RIVIAN_WAYPOINTS,2,0,2,1,1
ID,RIVIAN_WAYPOINTS,2,0,2,1,1
NE,RIVIAN_WAYPOINTS,2,0,2,1,1
TX,RIVIAN_WAYPOINTS,2,0,2,1,1
WI,RIVIAN_WAYPOINTS,2,0,2,1,1
ME,RIVIAN_WAYPOINTS,2,0,2,1,1
UT,RIVIAN_WAYPOINTS,2,0,2,1,1
WV,SHELL_RECHARGE,2,0,2,1,1
NJ,STAY_N_CHARGE,2,0,2,1,1
NV,STAY_N_CHARGE,2,0,2,1,1
LA,STAY_N_CHARGE,2,0,2,1,1
IA,STAY_N_CHARGE,2,0,2,1,1
WI,SWTCH,2,0,2,2,1
MN,SWTCH,2,0,2,1,1
MO,TURNONGREEN,2,0,2,1,1
NY,TURNONGREEN,2,0,2,1,1
LA,TURNONGREEN,2,0,2,1,1
CO,UNIVERSAL,2,0,2,1,1
ME,UNIVERSAL,2,0,2,1,1
NY,UNIVERSAL,2,0,2,1,1
KS,UNIVERSAL,2,0,2,2,1
UT,VIALYNK,2,0,2,1,1
OH,VIALYNK,2,2,0,1,1
WY,VIALYNK,2,2,0,1,1
NV,VIALYNK,2,0,2,1,0
IA,VIALYNK,2,0,2,1,1
KY,ZEFNET,2,2,0,1,1
MT,ZEFNET,2,2,0,1,1
ND,ZEFNET,2,0,2,1,1
CO,ZEFNET,2,2,0,1,1
VT,eVgo Network,2,2,0,1,1
TN,ABM,3,0,3,1,1
IN,ABM,3,0,3,2,1
GA,ABM,3,0,3,2,1
NM,AMPUP,3,0,3,1,1
OR,AUTEL,3,0,3,1,1
WI,CHARGELAB,3,0,3,2,1
VA,CHARGESMART_EV,3,0,3,1,1
CA,CHARGESMART_EV,3,2,1,2,0.5
FL,EPIC_CHARGING,3,0,3,1,1
FL,EVIUM,3,0,3,1,1
NC,EVMATCH,3,0,3,2,1
OR,EVMATCH,3,0,3,1,1
NC,EVOKE,3,0,3,1,1
FL,FLO,3,1,2,2,1
MA,IN_CHARGE,3,1,2,1,1
GA,IN_CHARGE,3,1,2,1,1
LA,JULE,3,3,0,1,1
NM,NOODOE,3,0,3,1,1
LA,NOODOE,3,0,3,2,1
IL,OpConnect,3,0,3,2,0.5
PR,OpConnect,3,0,3,2,1
ID,OpConnect,3,0,3,2,1
MO,RIVIAN_WAYPOINTS,3,0,3,2,1
MO,SWTCH,3,0,3,1,1
IL,TURNONGREEN,3,0,3,2,1
AZ,TURNONGREEN,3,0,3,2,1
OK,TURNONGREEN,3,0,3,3,0.66666666666666663
CA,WAVE,3,3,0,1,0
OH,ABM,4,0,4,1,1
PR,ABM,4,0,4,1,1
WI,ABM,4,2,2,1,1
MT,AMPUP,4,0,4,2,1
ID,AMPUP,4,0,4,2,1
AR,AMPUP,4,0,4,2,1
WI,BP_PULSE,4,4,0,1,1
VA,BP_PULSE,4,4,0,1,1
IN,BP_PULSE,4,4,0,1,1
VA,CHAEVI,4,4,0,1,1
TN,CHAEVI,4,4,0,2,1
IN,CHARGESMART_EV,4,4,0,2,1
MD,CHARGEUP,4,0,4,2,1
VA,CIRCLE_K,4,4,0,1,1
CA,DIRT_ROAD,4,0,4,1,1
NM,ELECTRIC_ERA,4,4,0,1,1
KY,ELECTRIC_ERA,4,4,0,1,1
MS,ELECTRIC_ERA,4,4,0,1,1
MO,ELECTRIC_ERA,4,4,0,1,1
DE,ELECTRIC_ERA,4,4,0,1,1
NC,ENVIROSPARK,4,0,4,2,1
NY,EPIC_CHARGING,4,0,4,1,1
UT,EV Connect,4,2,2,3,1
CO,EVBOLT,4,0,4,2,1
NH,EVIUM,4,2,2,1,1
VA,EVIUM,4,0,4,1,1
PA,EVMATCH,4,0,4,1,1
HI,EVOKE,4,0,4,1,1
CT,EVRANGE,4,0,4,1,1
TX,EVRANGE,4,0,4,2,1
RI,Electrify America,4,4,0,1,1
AR,FCN,4,4,0,1,0
MI,FLASH,4,0,4,1,1
VA,FLASH,4,0,4,1,1
AK,FLO,4,3,1,2,1
DC,FLO,4,4,0,1,1
RI,FLO,4,0,4,1,1
VT,FORD_CHARGE,4,4,0,2,1
AR,FORD_CHARGE,4,4,0,1,1
WV,FORD_CHARGE,4,4,0,1,1
DE,FORD_CHARGE,4,4,0,1,1
WY,FORD_CHARGE,4,4,0,1,1
CO,GRAVITI_ENERGY,4,4,0,1,1
NJ,IN_CHARGE,4,3,1,2,1
NY,JULE,4,4,0,2,0.5
CO,JULE,4,4,0,1,1
WI,LOOP,4,0,4,1,1
NJ,NOODOE,4,4,0,1,1
MN,NOODOE,4,4,0,2,1
OH,OpConnect,4,0,4,1,1
AZ,OpConnect,4,0,4,1,1
TX,OpConnect,4,0,4,2,1
OH,POWERCHARGE,4,0,4,1,1
KS,POWERPORT_EVC,4,0,4,2,1
SC,POWERPORT_EVC,4,0,4,1,1
FL,POWERPUMP,4,0,4,1,1
OK,RIVIAN_WAYPOINTS,4,0,4,2,1
MT,RIVIAN_WAYPOINTS,4,0,4,1,1
PA,RIVIAN_WAYPOINTS,4,0,4,2,1
OH,RIVIAN_WAYPOINTS,4,0,4,2,1
MS,SHELL_RECHARGE,4,0,4,2,1
AR,SHELL_RECHARGE,4,4,0,1,1
OR,STAY_N_CHARGE,4,0,4,2,1
OK,STAY_N_CHARGE,4,0,4,2,1
DE,SWTCH,4,0,4,1,1
KS,SWTCH,4,0,4,3,1
UT,SWTCH,4,0,4,2,1
NV,TURNONGREEN,4,0,4,1,1
MN,TURNONGREEN,4,0,4,1,1
PA,TURNONGREEN,4,0,4,1,1
OR,TURNONGREEN,4,0,4,2,1
GA,TURNONGREEN,4,0,4,3,0.66666666666666663
NJ,TURNONGREEN,4,0,4,3,1
MT,TURNONGREEN,4,0,4,2,0.5
GA,UNIVERSAL,4,0,4,1,1
IN,VIALYNK,4,0,4,2,1
NH,ZEFNET,4,0,4,2,1
WY,ZEFNET,4,2,2,1,1
IN,ZEFNET,4,0,4,2,1
NE,ZEFNET,4,2,2,1,1
SD,eVgo Network,4,4,0,1,0
WV,eVgo Network,4,4,0,1,1
VA,ABM,5,2,3,3,1
NY,AUTEL,5,4,1,2,1
OH,CHARGELAB,5,0,5,2,1
SC,CHARGELAB,5,0,5,3,0.66666666666666663
NH,CHARGELAB,5,0,5,2,1
ID,CHARGEUP,5,0,5,1,1
VA,EPIC_CHARGING,5,0,5,1,1
MI,EPIC_CHARGING,5,0,5,1,1
ID,EVGATEWAY,5,5,0,2,1
WV,LOOP,5,0,5,2,1
AR,NOODOE,5,3,2,3,1
VT,OpConnect,5,0,5,2,1
ID,RED_E,5,4,1,2,1
VA,RED_E,5,0,5,1,1
CO,STAY_N_CHARGE,5,0,5,1,1
SC,ZEFNET,5,2,3,4,1
OR,ABM,6,0,6,1,1
NC,AMPED_UP,6,0,6,1,1
KS,AMPUP,6,0,6,3,1
VT,AUTEL,6,0,6,2,1
VA,AUTEL,6,4,2,2,1
TX,AUTEL,6,4,2,2,1
NJ,BP_PULSE,6,6,0,2,1
AL,CHAEVI,6,6,0,3,1
MD,CHARGELAB,6,2,4,2,1
FL,ELECTRIC_ERA,6,6,0,1,1
GA,ENVIROSPARK,6,0,6,1,1
RI,EV Connect,6,2,4,2,1
AL,EVBOLT,6,0,6,1,1
NE,EVGATEWAY,6,0,6,2,1
FL,EVRANGE,6,0,6,2,1
DE,FLASH,6,0,6,1,1
AL,FLO,6,6,0,3,1
SC,FLO,6,0,6,3,1
NH,FLO,6,0,6,2,1
NC,FLO,6,0,6,3,1
NV,FORD_CHARGE,6,6,0,2,1
SD,FORD_CHARGE,6,6,0,1,1
UT,FORD_CHARGE,6,6,0,3,0.66666666666666663
OK,IN_CHARGE,6,4,2,1,1
MI,JULE,6,6,0,3,1
MO,LOOP,6,0,6,3,1
NV,LOOP,6,0,6,1,1
MI,LOOP,6,6,0,2,1
AR,LOOP,6,0,6,1,1
SC,LOOP,6,0,6,2,1
CO,NOODOE,6,0,6,2,1
MI,NOODOE,6,0,6,2,1
NV,NOODOE,6,0,6,1,1
IN,NOODOE,6,0,6,2,1
GA,OBE_POWER,6,0,6,6,1
FL,OpConnect,6,0,6,3,1
CA,POWERPORT_EVC,6,0,6,1,1
NJ,RED_E,6,6,0,1,1
MT,RED_E,6,6,0,2,0
NH,RED_E,6,2,4,2,0.5
MS,RED_E,6,3,3,3,1
SC,RIVIAN_ADVENTURE,6,6,0,1,1
RI,RIVIAN_ADVENTURE,6,6,0,1,1
WI,RIVIAN_ADVENTURE,6,6,0,1,1
TN,RIVIAN_ADVENTURE,6,6,0,1,1
MO,RIVIAN_ADVENTURE,6,6,0,1,1
IN,RIVIAN_ADVENTURE,6,6,0,1,1
NM,RIVIAN_ADVENTURE,6,6,0,1,1
NJ,RIVIAN_ADVENTURE,6,6,0,1,1
CT,RIVIAN_ADVENTURE,6,6,0,1,1
VT,RIVIAN_ADVENTURE,6,6,0,1,1
NH,RIVIAN_ADVENTURE,6,6,0,1,1
DE,RIVIAN_ADVENTURE,6,6,0,1,1
WY,RIVIAN_ADVENTURE,6,6,0,1,1
NV,RIVIAN_ADVENTURE,6,6,0,1,1
AR,RIVIAN_WAYPOINTS,6,0,6,3,1
NC,RIVIAN_WAYPOINTS,6,0,6,3,1
UT,SHELL_RECHARGE,6,0,6,2,1
ID,SHELL_RECHARGE,6,4,2,2,1
SC,STAY_N_CHARGE,6,0,6,3,1
VA,TURNONGREEN,6,0,6,2,1
IA,TURNONGREEN,6,0,6,2,1
WI,TURNONGREEN,6,0,6,3,1
NH,VIALYNK,6,0,6,3,1
AL,VIALYNK,6,4,2,2,0.5
MI,ZEFNET,6,2,4,3,1
SD,ZEFNET,6,2,4,2,1
WA,ZEFNET,6,0,6,2,1
DC,eVgo Network,6,6,0,2,1
NJ,ABM,7,4,3,2,1
KY,CHARGELAB,7,0,7,3,1
NM,EV Connect,7,7,0,5,1
MD,EVGATEWAY,7,0,7,3,1
NM,EVGATEWAY,7,4,3,3,1
IA,EVGATEWAY,7,0,7,2,1
TN,EVMATCH,7,0,7,4,1
DC,EVOKE,7,0,7,1,1
WI,NOODOE,7,0,7,4,1
IA,NOODOE,7,0,7,4,1
KY,RED_E,7,4,3,2,1
WA,RIVIAN_WAYPOINTS,7,0,7,2,1
OR,SWTCH,7,0,7,2,1
KY,UNIVERSAL,7,0,7,4,1
AR,UNIVERSAL,7,0,7,5,1
NC,ZEFNET,7,0,7,2,1
WA,7CHARGE,8,8,0,2,1
NE,ABM,8,6,2,1,1
PA,APPLEGREEN,8,8,0,2,1
NC,AUTEL,8,0,8,1,1
TN,BP_PULSE,8,8,0,2,1
OR,BP_PULSE,8,8,0,2,1
CO,CHAEVI,8,8,0,1,1
TN,CHARGELAB,8,0,8,2,1
KY,CIRCLE_K,8,8,0,2,1
TN,ELECTRIC_ERA,8,8,0,1,1
ND,EV Connect,8,8,0,4,1
CA,EVBOLT,8,0,8,2,1
WV,EVGATEWAY,8,0,8,3,1
IL,EVGATEWAY,8,0,8,2,1
KS,EVGATEWAY,8,6,2,3,0.66666666666666663
CO,EVOKE,8,0,8,3,1
CA,EVPASSPORT,8,4,4,2,1
ME,Electrify America,8,8,0,2,1
MA,Enel X Way,8,4,4,2,1
CO,FCN,8,8,0,2,1
IN,FCN,8,8,0,2,1
IL,FLASH,8,0,8,2,1
TN,FLASH,8,0,8,1,1
UT,FLASH,8,0,8,1,1
WA,FLASH,8,0,8,1,1
ND,FORD_CHARGE,8,8,0,2,1
RI,FORD_CHARGE,8,8,0,2,0.5
OK,FORD_CHARGE,8,8,0,2,1
NE,FORD_CHARGE,8,8,0,4,1
LA,GRAVITI_ENERGY,8,0,8,2,1
NV,HYPERFUEL,8,8,0,1,1
OR,IONNA,8,8,0,1,1
CT,MERCEDES_BENZ,8,8,0,5,1
PA,NOODOE,8,0,8,4,1
LA,POWERFLEX,8,0,8,1,1
MO,RED_E,8,6,2,4,1
CO,RED_E,8,8,0,3,1
DE,RED_E,8,4,4,1,1
NE,SWTCH,8,0,8,4,1
VA,SWTCH,8,0,8,2,1
AK,TURNONGREEN,8,0,8,3,1
NC,TURNONGREEN,8,0,8,4,0.5
VA,UNIVERSAL,8,0,8,4,1
NM,VIALYNK,8,8,0,1,1
DC,VIALYNK,8,0,8,4,1
VA,ZEFNET,8,0,8,2,1
IL,ZEFNET,8,2,6,4,1
ND,eVgo Network,8,8,0,2,1
DE,eVgo Network,8,8,0,2,1
RI,eVgo Network,8,8,0,2,1
MN,ABM,9,0,9,1,1
NY,AMPED_UP,9,0,9,2,1
NE,AMPUP,9,0,9,6,1
MD,OpConnect,9,0,9,2,1
MA,RIVIAN_ADVENTURE,9,9,0,1,1
VA,RIVIAN_WAYPOINTS,9,0,9,4,1
AK,Tesla Destination,9,0,9,5,1
MO,UNIVERSAL,9,4,5,5,1
MS,AMPUP,10,0,10,4,1
ND,AMPUP,10,0,10,1,1
IN,CHARGELAB,10,0,10,4,1
MO,CHARGELAB,10,0,10,3,0.66666666666666663
CT,CHARGELAB,10,0,10,1,1
NV,EVOKE,10,0,10,1,1
DC,Electrify America,10,9,1,2,1
HI,FLASH,10,0,10,2,1
IL,FLO,10,0,10,3,1
DE,FLO,10,0,10,2,1
NM,FORD_CHARGE,10,10,0,3,1
LA,FORD_CHARGE,10,10,0,3,1
MN,IONNA,10,10,0,1,1
MO,IONNA,10,10,0,1,1
GA,IONNA,10,10,0,1,1
FL,IONNA,10,10,0,1,1
CO,IONNA,10,10,0,1,1
AZ,IONNA,10,10,0,1,1
CA,IONNA,10,10,0,1,1
IL,IONNA,10,10,0,1,1
FL,JULE,10,10,0,4,1
OK,LOOP,10,4,6,2,1
ID,LOOP,10,6,4,3,1
DC,LOOP,10,0,10,2,1
KY,MERCEDES_BENZ,10,10,0,5,1
MO,MERCEDES_BENZ,10,10,0,6,1
NC,MERCEDES_BENZ,10,10,0,6,1
MA,MERCEDES_BENZ,10,10,0,6,1
CO,MERCEDES_BENZ,10,10,0,6,1
CO,OpConnect,10,0,10,3,1
NC,OpConnect,10,0,10,4,0.5
SD,RED_E,10,4,6,4,1
IA,SHELL_RECHARGE,10,10,0,3,1
PA,STAY_N_CHARGE,10,0,10,3,1
NC,STAY_N_CHARGE,10,0,10,5,1
AZ,SWTCH,10,2,8,7,1
PA,VIALYNK,10,0,10,3,1
TX,ZEFNET,10,4,6,4,1
NE,eVgo Network,10,10,0,2,1
PA,ABM,12,4,8,1,1
KY,AMPUP,12,0,12,4,1
KY,BP_PULSE,12,12,0,3,1
MD,BP_PULSE,12,12,0,1,1
WA,CIRCLE_K,12,12,0,3,1
PA,EPIC_CHARGING,12,0,12,2,1
HI,EV Connect,12,8,4,3,1
OH,EVGATEWAY,12,4,8,4,1
OH,EVIUM,12,0,12,1,1
IL,EVXY,12,10,2,2,1
HI,Electrify America,12,12,0,3,1
MS,Electrify America,12,12,0,2,1
DE,Electrify America,12,12,0,2,1
WI,FCN,12,12,0,3,1
KS,FCN,12,8,4,2,1
AL,FCN,12,12,0,2,1
IL,FCN,12,12,0,3,1
PA,FCN,12,12,0,3,1
CO,FLO,12,0,12,2,1
GA,FLO,12,6,6,4,1
CO,FORD_CHARGE,12,12,0,3,1
AZ,FORD_CHARGE,12,12,0,4,1
MA,FORD_CHARGE,12,12,0,3,1
AZ,RED_E,12,12,0,4,1
FL,RED_E,12,6,6,2,1
TX,RED_E,12,8,4,5,1
CA,REVEL,12,12,0,1,1
MN,RIVIAN_ADVENTURE,12,12,0,1,1
ID,RIVIAN_ADVENTURE,12,12,0,2,1
OH,RIVIAN_ADVENTURE,12,12,0,2,1
KS,RIVIAN_ADVENTURE,12,12,0,2,1
MD,RIVIAN_ADVENTURE,12,12,0,2,1
ME,RIVIAN_ADVENTURE,12,12,0,2,1
CA,ROVE,12,12,0,1,1
IN,SHELL_RECHARGE,12,0,12,5,1
MO,STAY_N_CHARGE,12,0,12,3,1
NH,SWTCH,12,0,12,2,1
ND,Tesla Destination,12,0,12,3,1
CA,UNIVERSAL,12,0,12,2,1
NY,ZEFNET,12,10,2,4,1
IA,ZEFNET,12,0,12,6,1
IA,eVgo Network,12,12,0,3,1
NH,eVgo Network,12,10,2,3,1
LA,eVgo Network,12,12,0,3,1
SC,AMPUP,13,3,10,7,1
WY,EV Connect,13,9,4,7,1
TX,EVBOLT,13,2,11,9,1
MT,EVGATEWAY,13,1,12,4,1
WI,EVGATEWAY,13,4,9,6,1
MD,FLO,13,0,13,2,1
TN,NOODOE,13,0,13,3,1
WV,RED_E,13,10,3,3,1
NV,RED_E,13,8,5,2,1
IL,RIVIAN_WAYPOINTS,13,0,13,3,1
KS,STAY_N_CHARGE,13,0,13,4,1
DE,Tesla Destination,13,0,13,7,1
GA,VIALYNK,13,0,13,3,0.33333333333333331
TX,7CHARGE,14,14,0,4,1
MA,AMPED_UP,14,0,14,2,1
PA,AUTEL,14,0,14,4,1
TX,CHAEVI,14,14,0,6,1
AL,CHARGELAB,14,4,10,4,1
IL,CHARGEUP,14,0,14,2,1
MT,EV Connect,14,14,0,5,1
MI,EVGATEWAY,14,12,2,5,1
TX,FLO,14,0,14,6,1
AL,FORD_CHARGE,14,14,0,3,1
MD,FORD_CHARGE,14,14,0,4,1
HI,LOOP,14,0,14,4,1
IN,LOOP,14,4,10,4,1
VA,NOODOE,14,2,12,2,1
GA,OpConnect,14,0,14,4,1
CA,RED_E,14,8,6,3,1
NH,SHELL_RECHARGE,14,4,10,7,1
IN,TURNONGREEN,14,0,14,7,1
WA,TURNONGREEN,14,0,14,3,1
SC,TURNONGREEN,14,0,14,1,1
SC,VIALYNK,14,0,14,7,0.8571428571428571
CO,7CHARGE,15,15,0,5,1
OR,AMPUP,15,0,15,12,1
AR,AUTEL,15,6,9,2,1
AZ,CHARGELAB,15,0,15,5,0.8
DE,EV Connect,15,7,8,5,1
WI,RED_E,15,8,7,6,1
IA,RED_E,15,14,1,6,0.83333333333333337
FL,RIVIAN_ADVENTURE,15,15,0,2,1
MI,RIVIAN_WAYPOINTS,15,0,15,9,1
FL,TURNONGREEN,15,0,15,4,0.75
UT,AMPUP,16,0,16,5,1
TX,CHARGELAB,16,5,11,6,0.66666666666666663
NH,CHARGEUP,16,0,16,2,0
AZ,CIRCLE_K,16,16,0,4,1
OR,ELECTRIC_ERA,16,16,0,3,1
IN,EVGATEWAY,16,0,16,4,1
CO,EVMATCH,16,0,16,6,1
UT,EVRANGE,16,0,16,4,0.75
FL,FCN,16,8,8,3,1
MN,FLO,16,0,16,7,1
MS,FORD_CHARGE,16,16,0,4,1
AZ,HYPERFUEL,16,16,0,2,0
NE,Non-Networked,16,3,13,13,1
CT,OpConnect,16,0,16,4,1
IL,RIVIAN_ADVENTURE,16,16,0,2,1
LA,SHELL_RECHARGE,16,6,10,6,1
MS,VIALYNK,16,8,8,4,1
KY,VIALYNK,16,0,16,5,0.8
MS,eVgo Network,16,16,0,4,1
ID,eVgo Network,16,16,0,4,1
WY,eVgo Network,16,16,0,4,1
NV,eVgo Network,16,16,0,5,1
AR,eVgo Network,16,16,0,4,1
FL,ABM,17,7,10,5,1
RI,Blink Network,17,0,17,6,0.83333333333333337
AL,EV Connect,17,12,5,11,0.90909090909090906
VT,EVMATCH,17,0,17,7,1
VA,MERCEDES_BENZ,17,17,0,10,1
ID,NOODOE,17,0,17,7,1
NV,OpConnect,17,0,17,6,0.83333333333333337
WA,POWERFLEX,17,0,17,3,1
AR,RED_E,17,10,7,3,1
MN,SHELL_RECHARGE,17,5,12,10,1
NV,SWTCH,17,0,17,4,1
HI,AMPUP,18,0,18,7,1
SD,EV Connect,18,14,4,4,1
LA,EV Connect,18,13,5,10,0.9
MS,EV Connect,18,17,1,11,0.90909090909090906
MO,EVGATEWAY,18,4,14,4,0.5
IL,EVOKE,18,0,18,2,1
KS,FORD_CHARGE,18,18,0,5,1
NJ,FORD_CHARGE,18,18,0,6,1
NH,FORD_CHARGE,18,18,0,4,1
OR,FORD_CHARGE,18,18,0,5,1
KY,LOOP,18,0,18,3,1
WA,NOODOE,18,2,16,6,1
MT,RIVIAN_ADVENTURE,18,18,0,3,1
LA,RIVIAN_ADVENTURE,18,18,0,3,1
TN,SHELL_RECHARGE,18,6,12,8,1
NC,UNIVERSAL,18,8,10,9,1
WY,Blink Network,19,0,19,7,1
AK,Blink Network,19,6,13,3,1
CO,CHARGELAB,19,0,19,5,1
WA,EVGATEWAY,19,2,17,5,0.8
AZ,EVMATCH,19,0,19,3,1
CT,EVOKE,19,0,19,5,1
NV,RIVIAN_WAYPOINTS,19,0,19,7,1
ME,eVgo Network,19,9,10,6,1
MA,BP_PULSE,20,20,0,1,1
LA,CHARGELAB,20,0,20,10,1
DC,EV Connect,20,0,20,7,1
UT,EVPOWER,20,20,0,5,1
KS,Electrify America,20,20,0,5,1
ME,FLO,20,0,20,8,1
CA,FORD_CHARGE,20,20,0,5,1
PA,IONNA,20,20,0,2,1
MD,LOOP,20,0,20,4,1
OR,NOODOE,20,0,20,7,1
OH,POWERFLEX,20,0,20,1,1
LA,RED_E,20,13,7,6,0.83333333333333337
DC,SHELL_RECHARGE,20,0,20,9,1
WA,SWTCH,20,0,20,3,1
AK,Tesla,20,20,0,3,1
NE,Tesla Destination,20,0,20,9,1
SD,Blink Network,21,4,17,10,0.8
PA,CHARGELAB,21,0,21,8,0.625
ID,EV Connect,21,6,15,8,0.875
SC,EVGATEWAY,21,8,13,7,0.7142857142857143
CA,FLITWAY,21,13,8,4,1
OH,NOODOE,21,4,17,5,1
VT,NOODOE,21,0,21,10,1
OR,RIVIAN_WAYPOINTS,21,0,21,9,1
TX,SWTCH,21,11,10,6,1
TN,SWTCH,21,0,21,9,0.88888888888888884
KS,eVgo Network,21,21,0,5,1
AK,ChargePoint Network,22,2,20,12,0.83333333333333337
WA,ELECTRIC_ERA,22,22,0,4,1
NH,EV Connect,22,8,14,8,0.875
WV,EV Connect,22,13,9,13,0.76923076923076927
VT,EV Connect,22,10,12,7,0.8571428571428571
CT,EVIUM,22,0,22,1,1
CA,Enel X Way,22,0,22,4,0.75
KY,FORD_CHARGE,22,22,0,5,1
ME,FORD_CHARGE,22,22,0,6,1
MI,OpConnect,22,0,22,16,1
PA,OpConnect,22,0,22,5,1
NY,RIVIAN_ADVENTURE,22,22,0,3,1
WI,eVgo Network,22,22,0,5,1
CT,eVgo Network,22,22,0,8,0.875
MN,eVgo Network,22,22,0,5,1
GA,CHARGELAB,23,2,21,7,1
CO,CIRCLE_K,23,23,0,7,1
VT,FLO,23,20,3,16,1
UT,LOOP,23,0,23,7,1
NC,SHELL_RECHARGE,23,10,13,9,1
GA,STAY_N_CHARGE,23,0,23,10,1
WA,ABM,24,0,24,6,1
TN,AMPUP,24,0,24,8,1
TX,BP_PULSE,24,24,0,1,1
ND,Blink Network,24,12,12,8,0.875
FL,CHARGELAB,24,0,24,8,0.875
OK,EV Connect,24,23,1,14,0.9285714285714286
TN,EV Connect,24,22,2,12,1
AK,EVGATEWAY,24,16,8,4,1
NJ,EVIUM,24,6,18,5,1
AR,Electrify America,24,24,0,5,0.8
ND,Electrify America,24,24,0,4,1
ID,Electrify America,24,24,0,6,1
OH,FCN,24,24,0,6,1
RI,FLASH,24,0,24,3,1
IN,FLO,24,0,24,11,1
IN,FORD_CHARGE,24,24,0,7,1
NY,GRAVITY_CHARGING_CENTER,24,24,0,1,1
WI,KWIK_CHARGE,24,24,0,6,1
LA,LOOP,24,0,24,6,1
SD,Non-Networked,24,6,18,15,0.93333333333333335
OH,UNIVERSAL,24,24,0,4,1
NC,VIALYNK,24,0,24,11,0.18181818181818182
CO,VIALYNK,24,0,24,6,0.66666666666666663
UT,eVgo Network,24,23,1,6,1
MS,Blink Network,26,12,14,9,1
TX,CIRCLE_K,26,26,0,7,1
ME,EVIUM,26,0,26,2,1
FL,EVOKE,26,0,26,5,1
LA,Electrify America,26,26,0,5,1
WY,Electrify America,26,26,0,6,1
SC,Electrify America,26,26,0,6,1
SD,Electrify America,26,26,0,5,1
NH,Electrify America,26,26,0,6,1
NE,Electrify America,26,26,0,6,1
TX,FCN,26,20,6,5,1
MN,FLASH,26,0,26,4,1
MO,FORD_CHARGE,26,26,0,8,1
UT,NOODOE,26,0,26,6,1
TN,OpConnect,26,0,26,4,1
IN,RED_E,26,14,12,12,0.91666666666666663
PA,RIVIAN_ADVENTURE,26,26,0,4,1
AR,STAY_N_CHARGE,26,0,26,13,0.92307692307692313
NM,eVgo Network,26,26,0,6,1
NV,AUTEL,28,20,8,1,1
WA,BP_PULSE,28,28,0,6,1
MT,Blink Network,28,8,20,11,0.90909090909090906
CA,CHARGENET,28,28,0,4,1
IL,CIRCLE_K,28,28,0,7,1
FL,CIRCLE_K,28,28,0,7,1
AR,EV Connect,28,22,6,12,0.91666666666666663
KS,EV Connect,28,22,6,10,0.9
KY,Electrify America,28,28,0,6,1
IA,Electrify America,28,28,0,6,1
PA,FORD_CHARGE,28,28,0,9,1
GA,MERCEDES_BENZ,28,28,0,16,1
VA,OpConnect,28,2,26,5,0.4
ME,RED_E,28,0,28,5,1
PR,SWTCH,28,0,28,12,1
OR,ZEFNET,28,4,24,11,1
OK,eVgo Network,28,28,0,7,0.8571428571428571
CO,AUTEL,30,0,30,2,1
MA,CHARGESMART_EV,30,24,6,4,1
ME,EVGATEWAY,30,0,30,7,0.8571428571428571
KY,FLO,30,0,30,5,1
KS,IONNA,30,30,0,3,1
OR,LOOP,30,0,30,5,1
TN,MERCEDES_BENZ,30,30,0,18,1
MO,NOODOE,30,4,26,5,1
MN,OpConnect,30,0,30,6,1
OH,RED_E,30,20,10,6,1
WA,RED_E,30,12,18,6,1
TX,RIVIAN_ADVENTURE,30,30,0,5,1
AL,eVgo Network,30,30,0,7,1
IA,AMPUP,31,0,31,5,1
ME,EV Connect,31,14,17,15,0.93333333333333335
IL,SWTCH,31,0,31,6,1
FL,SWTCH,31,1,30,10,1
TX,VIALYNK,31,0,31,10,0.6
IN,eVgo Network,31,29,2,8,1
GA,AUTEL,32,16,16,11,1
NC,CHARGELAB,32,8,24,8,1
GA,CIRCLE_K,32,32,0,8,1
AZ,EVGATEWAY,32,2,30,9,0.77777777777777779
MS,NOODOE,32,25,7,5,1
MA,OpConnect,32,0,32,3,0.33333333333333331
MI,SWTCH,32,0,32,5,1
RI,Tesla Destination,32,0,32,7,1
TN,ZEFNET,32,28,4,6,1
KY,eVgo Network,32,32,0,8,1
NH,AMPUP,34,0,34,16,1
OR,EV Connect,34,5,29,14,0.9285714285714286
OR,EVGATEWAY,34,26,8,4,0.75
MA,EVGATEWAY,34,2,32,9,1
TN,FORD_CHARGE,34,34,0,9,1
NY,OpConnect,34,0,34,4,1
NC,RED_E,34,12,22,6,1
SC,RED_E,34,22,12,6,1
MN,AMPUP,36,0,36,11,1
PA,CHARGESMART_EV,36,12,24,3,1
VA,EVGATEWAY,36,0,36,8,0.75
NV,EVGATEWAY,36,4,32,7,0.8571428571428571
IA,FORD_CHARGE,36,36,0,9,1
MN,FORD_CHARGE,36,36,0,12,1
AZ,NOODOE,36,0,36,7,1
FL,OBE_POWER,36,0,36,30,1
NC,RIVIAN_ADVENTURE,36,36,0,6,1
NV,SHELL_RECHARGE,36,6,30,6,0.83333333333333337
FL,STAY_N_CHARGE,36,0,36,12,1
UT,TURNONGREEN,36,0,36,2,1
DC,Tesla,36,36,0,4,1
PA,UNIVERSAL,36,0,36,10,1
OR,WATT_EV,36,36,0,1,0
TX,ABM,38,3,35,7,1
NJ,APPLEGREEN,38,38,0,8,1
SC,CIRCLE_K,38,38,0,10,1
IL,EVMATCH,38,0,38,10,1
AL,Electrify America,38,38,0,9,1
MT,Electrify America,38,38,0,8,1
GA,FORD_CHARGE,38,38,0,10,1
IL,LOOP,38,0,38,10,1
MD,NOODOE,38,0,38,5,1
UT,OpConnect,38,0,38,1,1
UT,POWERPUMP,38,6,32,6,1
OR,eVgo Network,38,38,0,10,1
WI,AMPUP,40,0,40,18,1
MA,AUTEL,40,30,10,12,1
MN,CIRCLE_K,40,40,0,10,1
CA,ELECTRIC_ERA,40,40,0,5,1
AR,EVGATEWAY,40,6,34,14,0.5
CT,Electrify America,40,40,0,7,1
DC,FLASH,40,0,40,12,1
AL,MERCEDES_BENZ,40,40,0,21,1
NV,EV Connect,42,16,26,13,0.84615384615384615
WA,FORD_CHARGE,42,42,0,10,1
NC,IONNA,42,42,0,4,1
VA,RIVIAN_ADVENTURE,42,42,0,7,1
CO,RIVIAN_ADVENTURE,42,42,0,7,1
WY,Tesla Destination,42,0,42,17,1
VA,AMPUP,46,0,46,13,1
WY,ChargePoint Network,46,6,40,28,1
TX,EVGATEWAY,46,6,40,8,0.875
WI,Electrify America,46,46,0,8,1
MD,FLASH,46,0,46,9,1
OH,FORD_CHARGE,46,46,0,12,1
FL,FORD_CHARGE,46,46,0,12,1
WI,OpConnect,46,0,46,2,0.5
GA,RIVIAN_WAYPOINTS,46,0,46,7,1
RI,SHELL_RECHARGE,46,18,28,19,1
PA,AMPUP,48,0,48,18,1
ME,AMPUP,48,0,48,16,1
MO,EV Connect,48,40,8,22,0.95454545454545459
VA,FORD_CHARGE,48,48,0,14,0.7857142857142857
OH,IONNA,48,48,0,5,1
AZ,RIVIAN_ADVENTURE,48,48,0,8,1
MI,RIVIAN_ADVENTURE,48,48,0,8,1
FL,SHELL_RECHARGE,48,7,41,18,1
RI,Tesla,48,48,0,6,1
MI,eVgo Network,48,48,0,12,1
NH,Blink Network,50,16,34,17,0.88235294117647056
PR,Blink Network,50,0,50,26,0.88461538461538458
OK,Electrify America,50,50,0,10,1
NC,FORD_CHARGE,50,50,0,14,0.9285714285714286
NC,NOODOE,50,0,50,5,1
AL,RED_E,50,20,30,7,1
NV,AMPUP,54,0,54,11,1
NC,CIRCLE_K,54,50,4,12,1
ND,ChargePoint Network,54,13,41,35,1
NM,Electrify America,54,54,0,11,1
TX,IONNA,54,54,0,6,1
SC,RIVIAN_WAYPOINTS,54,0,54,27,1
NJ,SWTCH,54,0,54,12,0.75
HI,Tesla,54,54,0,5,1
FL,7CHARGE,56,56,0,16,0.9375
FL,BP_PULSE,56,56,0,10,1
NJ,CHARGELAB,56,2,54,9,0.77777777777777779
MD,EV Connect,56,8,48,19,0.94736842105263153
WA,LOOP,56,0,56,8,1
MT,Non-Networked,56,0,56,29,0.93103448275862066
WA,AMPUP,57,0,57,14,1
IN,AMPUP,57,0,57,35,1
WI,EV Connect,57,45,12,23,0.95652173913043481
UT,EVGATEWAY,57,11,46,8,0.875
NM,RED_E,57,30,27,24,0.625
CO,RIVIAN_WAYPOINTS,57,0,57,26,1
IL,FORD_CHARGE,60,60,0,14,1
TN,LOOP,60,0,60,9,1
NY,NOODOE,60,6,54,14,0.9285714285714286
NY,POWERFLEX,60,0,60,1,1
OR,RIVIAN_ADVENTURE,60,60,0,10,1
ND,Tesla,60,60,0,7,1
CA,CHAEVI,64,58,6,10,1
WV,ChargePoint Network,64,14,50,41,1
PA,EVGATEWAY,64,10,54,15,0.93333333333333335
MI,FORD_CHARGE,64,64,0,18,0.94444444444444442
AZ,LOOP,64,0,64,18,1
PA,RED_E,64,20,44,11,1
HI,Tesla Destination,64,0,64,19,1
NY,APPLEGREEN,72,72,0,13,1
CT,EV Connect,72,15,57,22,0.90909090909090906
WI,FORD_CHARGE,72,72,0,18,1
FL,NOODOE,72,8,64,20,1
IL,RED_E,72,38,34,15,1
IA,Tesla Destination,72,0,72,25,1
WA,CHARGELAB,80,6,74,3,1
SC,EV Connect,80,71,9,40,0.95
CA,HYPERFUEL,80,80,0,10,0
GA,RED_E,80,46,34,15,1
NY,REVEL,80,80,0,6,1
WY,Tesla,80,80,0,12,1
MO,eVgo Network,80,80,0,25,1
MD,AMPUP,100,0,100,16,1
TX,FORD_CHARGE,100,100,0,26,1
VA,LOOP,100,2,98,10,1
IA,Non-Networked,100,9,91,67,0.9850746268656716
CT,SWTCH,100,22,78,23,0.95652173913043481
IL,UNIVERSAL,100,100,0,25,1
